id	name
a	A
aa	AA
b	B
bb	BB
c	C
cc	CC
d	D
dd	DD
e	E
ee	EE
f	F
ff	FF
g	G
gg	GG
h	H
hh	HH
i	I
ii	II
j	J
jj	JJ
k	K
kk	KK
l	L
ll	LL
m	M
mm	MM
n	N
nn	NN
o	O
oo	OO
p	P
pp	PP
q	Q
qq	QQ
r	R
rr	RR
s	S
ss	SS
t	T
tt	TT
u	U
uu	UU
v	V
vv	VV
w	W
ww	WW
x	X
xx	XX
y	Y
yy	YY
z	Z
zz	ZZ
